000011110011000000004411220000
000011110011000000004411220000
000000440044110000000044110000
000000440044110000000044110000
001122001100442244110011220022
001122001100442244110011220022
001155000000440000110011001111
001155000000440000110011001111
110000443311440011001155000044
110000443311440011001155000044
003311005500001122004400220000
003311005500001122004400220000
110044335500110055002222000011
110044335500110055002222000011
000011001133000000440011440033
000011001133000000440011440033
000044443311001100004400000044
000044443311001100004400000044
111111000011114400440000001122
111111000011114400440000001122
002200220000440000000000111111
002200220000440000000000111111
113300554400221100004433111111
113300554400221100004433111111
115500550011114455005533001111
115500550011114455005533001111
110011003333331100111111110000
110011003333331100111111110000
222200111100440000001122005500
222200111100440000001122005500
111100003300003322000044110011
111100003300003322000044110011
333333005500220011330011330000
333333005500220011330011330000
330011110000000000331155443300
330011110000011110331155443300
114411000000016610003300440011
114411000000016610003300440011