000000000000000000000000000000
000000000000000000000000000000
000000000000000000000000000000
111100111100111111001111001111
111100111100111111001111001111
111100111100111111001111001111
111100111100111111001111001111
000000000000000000000000000000
111100000000111111000000001111
111100000000111111000000001111
000000000000000000000000000000
111100111100111111001111001111
111100111100111111001111001111
000000000000000000000000000000
111100111100111111001111001111
111100111100111111001111001111
111100111100000000001111001111
111100111100000000001111001111
000000000000000000000000000000
000000000000000000000000000000
000111111111110011111111111000
000111111111110011111111111000
000000111100000000001111000000
000000111100000000001111000000
000000000000000000000000000000
111100111100111111001111001111
111100111100111111001111001111
000000000000000000000000000000
111100111100111111001111001111
111100111100111111001111001111
000000000000000000000000000000
111100111100111111001111001111
111100111100111111001111001111
111100111100000000001111001111
000000000000000000000000000000
000000000000011110000000000000
000000000000016610000000000000
000000000000016610000000000000