000000000000000000000000000000
000000000000000000000000000000
000000000000000000000000000000
444400000011111111110000004444
444400000011111111110000004444
444400220000000000000022004444
444400220011000011000022004444
000000000011000011000000000000
000000000000000000000000000000
444444001111111111111100444444
444444001111111111111100444444
444444000000000000000000444444
444444000000000000000000444444
000000002222000022220000000000
000000002222000022220000000000
111100000000000000000000001111
111100444444444444444400001111
000000444444444444444400000000
000000000000000000000000000000
000000001111111111110000000000
444444001111111111110044444444
444444000000000000000044444444
444444000000000000000044444444
000000002200000000220000000000
111100002200000000220000001111
111100000000000000000000001111
000000001111000011110000000000
444444001111000011110044444444
444444000000000000000044444444
000000000000000000000000000000
000000004444444444440000000000
000000004444444444440000000000
000000000000000000000000000000
220000000111111111110000000022
220000000111166111110000000022
000000000111166111110000000000
000000000111111111110000000000
000000000000000000000000000000