000000000000000000000000000000
000000000000000000000000000000
000000000000000000000000000000
111100111100000000001111001111
111100111100000000001111001111
111100111100000000001111001111
111100111100000000001111001111
000000000000000000000000000000
111100111100111111001111001111
111100111100111111001111001111
111100111100111111001111001111
111100111100111111001111001111
000000000000000000000000000000
000000000000000000000000000000
000000111100222222001111000000
000000111100222222001111000000
000000111100222222001111000000
000000111100222222001111000000
000000000000000000000000000000
000000000000000000000000000000
111100111100000000001111001111
111100111100000000001111001111
111100111100000000001111001111
111100111100000000001111001111
111100000000222222000000001111
111100000000222222000000001111
111100111100000000001111001111
111100111100000000001111001111
111100111100000000001111001111
111100111100000000001111001111
000000000000000000000000000000
000000000000000000000000000000
111100111100000000001111001111
111100111100000000001111001111
111100111100000000001111001111
000000000000011110000000000000
000000000000016610000000000000
000000000000016610000000000000