000000000000000000000000000000
000000000000000000000000000000
000000000000000000000000000000
111100003333000000003333000011
111100003333000000003333000011
000000000000001111000000000000
222200111100001111000011110022
222200111100000000000011110022
000000000000000000000000000000
444444000044444444444400004444
444444000044444444444400004444
000000000000002200000000000000
111100555555002200555555001111
111100555555000000555555001111
000000552255003300552255000000
000000552255003300552255000000
111100555555000000555555001111
111100555555002200555555001111
000000000000002200000000000000
444444000044444444444400004444
444444000044444444444400004444
000000000000000000000000000000
111100222200111111002222001111
111100222200111111002222001111
000000000000000000000000000000
333300111100333333001111003333
333300111100333333001111003333
000000000000000000000000000000
110000111111000000111111000011
110000111111000000111111000011
000000000000000000000000000000
111100000011111111110000001111
111100000011111111110000001111
000000000000000000000000000000
000000000001111110000000000000
000000000001666610000000000000
000000000001666610000000000000
000000000001111110000000000000