000011000011110000001122110000
000011000011110000001122110000
000022110011000000000000220000
000022110011000000000000220000
550000111100001122000055001100
550000111100001122000055001100
002211443300331100001100003311
002211443300331100001100003311
004411005511110000002211440000
004411005511110000002211440000
441111224455444411550022550011
441111224455444411550022550011
111155111144112200001100442200
111155111144112200001100442200
001144440000110011220011000000
001144440000110011220011000000
001100000000110055001100114411
001100000000110055001100114411
004400001111115511000011111111
004400001111115511000011111111
000022001122110022111100002200
000022001122110022111100002200
555522110044111100110044110000
555522110044111100110044110000
445500440022110011000000113311
445500440022110011000000113311
110044002211000022111100000000
110044002211000022111100000000
111111001111000000111111000011
111111001111000000111111000011
000000111100002222000000001100
000000111100002222000000001100
553311111111110022110000111100
553311111111110022110000111100
110055334400000011000000111111
110055334400022211000000111111
441100551100026620003311001133
441100551100026620003311001133