000000000000000000000000000000
000000000000000000000000000000
000000000000000000000000000000
333330011110000000000111100333
333330011110000000000111100333
333330011110033333300111100333
333330000000033333300000000333
000000111100000000000011110000
111100111100222002220011110011
111100111100222002220011110011
000000000000000000000000000000
333333333001111111111003333333
333333333001111111111003333333
333333333000000000000003333333
000000000022220022220000000000
111100110022220022220011001111
111100110000000000000011001111
000000000033333333330000000000
333300333333333333333333003333
333300333333333333333333003333
000000000033333333330000000000
111100110000000000000011001111
111100110022220022220011001111
000000000022220022220000000000
333333333000000000000003333333
333333333001111111111003333333
333333333001111111111003333333
000000000000000000000000000000
111100111100222002220011110011
111100111100222002220011110011
000000000000000000000000000000
333330000000033333300000000333
333330011110033333300111100333
333330011110000000000111100333
000000000000000000000000000000
000000000000011110000000000000
000000000000116611000000000000
000000000000116611000000000000