000044220000000000003322330000
000044220000000000003322330000
000011333300000000332211000000
000011333300000000332211000000
110000220011110022001133000033
110000220011110022001133000033
110000550055110000000000550055
110000550055110000000000550055
000000000022220000001100220000
000000000022220000001100220000
000022114411000011000011005500
000022114411000011000011005500
002200110011000011553300001144
002200110011000011553300001144
114455110022000011110011004400
114455110022000011110011004400
000011112200332211330000000011
000011112200332211330000000011
000000000000002222330011111100
000000000000002222330011111100
330000550055111100112233111100
330000550055111100112233111100
000011000044110011000000000022
000011000044110011000000000022
004444003344330000333300112200
004444003344330000333300112200
224411002222003300001100111122
224411002222003300001100111122
000044110044333300002211005500
000044110044333300002211005500
555511002200111100114422002200
555511002200111100114422002200
000000000044002211001111220000
000000000044002211001111220000
004400000000000000443333003322
004400000000022220443333003322
440033000000026620000000000000
440033000000026620000000000000