000000000000000000000000000000
000000000000000000000000000000
000000000000000000000000000000
222211000033333333000000002222
222211000033333333000000002222
000000000033333333111100000000
333311001111000000111100444444
333311001111000000111100444444
000022000000002222000000444444
111122005555552222555500000000
111100005555550000555500111111
000000005555550000555500111111
444444000000000022220000000000
444444001111000022220011110033
000000001111000000000011110033
555555000000444444440000000000
555555003333444444443333002222
000000003333000000003333002222
221122000000111111000000000000
221122002222111111222200111111
000000002222000000222200111111
333300555555555555555500000000
333300555555555555555500444444
000000000000000000000000444444
111111110022222200111111000000
111111110022222200111111001111
000000000000000000000000001111
222200444444005555550022220000
222200444444005555550022220000
000000000000005555550000000000
001111000000000000000000111100
001111003333333333330000111100
000000003333333333330000000000
002222000000000000000000221100
002222000001111110000000221100
000000000001666610000000000000
000000000001666610000000000000
000000000001111110000000000000