221111220011100001110022111122
221111220011100001110022111122
000000000000000000000000000000
220022111122002200221111220022
220022111122002200221111220022
000000000000000000000000000000
111100555555444444555555001111
111100555555444444555555001111
000000550000002200000055000000
333300550022222222220055003333
333300550022222222220055003333
000000000022000000220000000000
444444001111000000111100444444
444444001111000000111100444444
000000000000444444000000000000
221122003333444444333300221122
221122003333000033333300221122
000000003300111100330000000000
000000003300166100330000000000
000000003300166100330000000000
000000003300111100330000000000
221122003333000033333300221122
221122003333444444333300221122
000000000000444444000000000000
444444001111000000111100444444
444444001111000000111100444444
000000000022000000220000000000
333300550022222222220055003333
333300550022222222220055003333
000000550000002200000055000000
111100555555444444555555001111
111100555555444444555555001111
000000000000000000000000000000
220022111122002200221111220022
220022111122002200221111220022
000000000000000000000000000000
221111220011100001110022111122
221111220011100001110022111122