000000000000000000000000000000
000000000000000000000000000000
000000000000000000000000000000
000111001001001110010010000000
000101001001001010011010000000
000111001001001110010110000000
000101001001001010010010000000
000101000110001010010010000000
000000000000000000000000000000
444400444444444444444400444444
444400444444444444444400444444
000000000000000000000000000000
333003333333333333333333003333
000000000000000000000000000000
011001001110101011101010000000
100101000100101010001110000000
101101000100111011101010000000
100101000100101010001010000000
011101001110101011101010000000
000000000000000000000000000000
555555555555555555555555555555
555555555555555555555555555555
000000000000000000000000000000
220000111100000000111100000022
220000111100000000111100000022
000000000000222200000000000000
000000000000222200000000000000
111100003333333333330000011111
111100003333333333330000011111
000000000000000000000000000000
000000000000000000000000000000
111100111100000000111100111111
111100111100000000111100111111
000000000000000000000000000000
000000000001111110000000000000
000000000001666610000000000000
000000000001666610000000000000
000000000001111110000000000000