000000000000000000000000000000
000000000000000000000000000000
000000000000000000000000000000
222200002222000000222200002222
222200002222000000222200002222
222200002222000000222200002222
000000000000000000000000000000
000000000000000000000000000000
222222000000222222000000222222
222222000000222222000000222222
000000000000000000000000000000
000000000000000000000000000000
222200002222000000222200002222
222200002222000000222200002222
000000000000000000000000000000
000000000000000000000000000000
222222000000222222000000222222
222222000000222222000000222222
000000000000000000000000000000
000000000000000000000000000000
222200002222000000222200002222
222200002222000000222200002222
000000000000000000000000000000
000000000000000000000000000000
222222000000222222000000222222
222222000000222222000000222222
000000000000000000000000000000
000000000000000000000000000000
222222220000000000000022222222
222222220000000000000022222222
000000000000000000000000000000
000000000000000000000000000000
222222220000111111000022222222
222222220000166661000022222222
000000000000166661000000000000
000000000000111111000000000000
000000000000000000000000000000
000000000000000000000000000000