000000334400000000113300000000
000000334400000000113300000000
000011112200110000330000000000
000011112200110000330000000000
001100220000110011111111001111
001100220000110011111111001111
001100000000114400002200005500
001100000000114400002200005500
110000330011111111002200110022
110000330011111111002200110022
111144110055000011440022004400
111144110055000011440022004400
000044111100333300111100440000
000044111100333300111100440000
004400110000000011004411335500
004400110000000011004411335500
000000000011005500002200000044
000000000011005500002200000044
000000001144440033443300000000
000000001144440033443300000000
220000004400004455000000000000
220000004400004455000000000000
000044000000000000440011332211
000044000000000000440011332211
000011000000554433001100224444
000011000000554433001100224444
220033224433110000004400330011
220033224433110000004400330011
001111110044000022110000005533
001111110044000022110000005533
000000221144442200001155000000
000000221144442200001155000000
553322111111110044001100004400
553322111111110044001100004400
114400333300000000000000550022
114400333300011110000000550022
554433001100016610550000554400
554433001100016610550000554400