000000000000000000000000000000
000000000000000000000000000000
000000000000000000000000000000
110003333300001100003333300011
110003333300001100003333300011
000000000000002200000000000000
110044440011002200110044440011
110044440011000000110044440011
000000000000000000000000000000
111100111100555555001111001111
111100111100555555001111001111
000000000000000000000000000000
333300222200333333002222003333
333300222200333333002222003333
000000000000000000000000000000
004444001111111111111100444400
004444001111111111111100444400
000000000000000000000000000000
111100555555000000555555001111
111100555555000000555555001111
000000000000222200000000000000
003333001100222200110033330000
003333001100000000110033330000
000000000000111100000000000000
222200222200111100222200222200
222200222200000000222200222200
000000000000000000000000000000
111100333300111100333300111100
111100333300111100333300111100
000000000000000000000000000000
111100000044444444000000111100
111100000044444444000000111100
000000000000000000000000000000
000000000001111110000000000000
000000000001666610000000000000
000000000001666610000000000000
000000000001111110000000000000
000000000000000000000000000000