000000000000000000000000000000
000000000000000000000000000000
000000000000000000000000000000
111100111100000000001111001111
111100111100000000001111001111
000000000000222222000000000000
111100111100222222001111001111
111100111100000000001111001111
000000000000000000000000000000
555555555500111111005555555555
555555555500111111005555555555
555555555500000000005555555555
555555555555555555555555555555
555555555555555555555555555555
555522555555550055555555225555
555522555555550055555555225555
555555555500000000005555555555
555555555500222222005555555555
555555555500222222005555555555
555555555500000000005555555555
555555555555555555555555555555
555555555555555555555555555555
555555555555555555555555555555
555555555500000000005555555555
555522555500111111005555225555
555522555500111111005555225555
555555555500000000005555555555
555555555555555555555555555555
555555555555555555555555555555
000000000000000000000000000000
111100111100000000001111001111
111100111100000000001111001111
000000000000000000000000000000
000000000000011110000000000000
000000000000011110000000000000
000000000000011110000000000000
000000000000016610000000000000
000000000000016610000000000000