000000000000000000000000000000
000000000000000000000000000000
000000000000000000000000000000
222222222200222222222200222222
110000001100000000001100000011
110022001100222222001100220011
000022000000220000000000220000
221122222211220022222211222222
221122222211220022222211222222
000000000000000000000000000000
333333004444444444444400333333
333333004444444444444400333333
000011000000002200000000110000
110011222222002200222222110011
110011222222002200222222110011
000000000000000000000000000000
555555555500111111005555555555
555555555500111111005555555555
000000002200000000002200000000
222211002222224422222200112222
222211002222224422222200112222
000011000000000000000000110000
110011111111113311111111110011
110011111111113311111111110011
000000000000000000000000000000
222222220022222222220022222222
222222220022222222220022222222
000000000000000000000000000000
111100555555555555555555001111
111100555555555555555555001111
000000000000000000000000000000
002222220000111111000022222200
002222220000111111000022222200
000000000000000000000000000000
000000000001111110000000000000
000000000001666610000000000000
000000000001666610000000000000
000000000001111110000000000000