000022332200110000115511000000
000022332200110000115511000000
000000110022330000004411000000
000000110022330000004411000000
110000111111002200550000110011
110000111111002200550000110011
001100220000000011000011110000
001100220000000011000011110000
111100111100000000441133001100
111100111100000000441133001100
000033004433110033000000001100
000033004433110033000000001100
004400000000005511110011001100
004400000000005511110011001100
220033001100003300000000002211
220033001100003300000000002211
110000000022111100003300225511
110000000022111100003300225511
550000110000110011002200332200
550000110000110011002200332200
000055111155220011000044441111
000055111155220011000044441111
111100005533443300221100330000
111100005533443300221100330000
112255550000000000550033001111
112255550000000000550033001111
331133111100000011550011000000
331133111100000011550011000000
222211115500002200000000113300
222211115500002200000000113300
112200000000111100001111001122
112200000000111100001111001122
441155111100114400001133003300
441155111100114400001133003300
001144331100000055001122000022
001144331100022255001122000022
003300331100026620000011001100
003300331100026620000011001100