000011115500000000002200110000
000011115500000000002200110000
000000005511000000001155330000
000000005511000000001155330000
000022110011113300331122000011
000022110011113300331122000011
112200113344441100000011440055
112200113344441100000011440055
000011330011005544003333114400
000011330011005544003333114400
002233000011001100220011110011
002233000011001100220011110011
000000110000110011113311551111
000000110000110011113311551111
000022441100000011113344115500
000022441100000011113344115500
553300441155111100223300330000
553300441155111100223300330000
001111003311440000000011000000
001111003311440000000011000000
331133004411000000001100000022
331133004411000000001100000022
440011110000440011222200113311
440011110000440011222200113311
331122002200330011005511001122
331122002200330011005511001122
001155003300333300000044000000
001155003300333300000044000000
331111110055331122441122441100
331111110055331122441122441100
001155112200003311330000331122
001155112200003311330000331122
000000551144001122003311220000
000000551144001122003311220000
111100000000000000110011000000
111100000000022220110011000000
110011331100026620000000000022
110011331100026620000000000022