221100112200000000000022110011
221100112200000000000022110011
000000000011112211110000000000
333333220011112211110000223333
333333220000000000000000223333
333333000011111111000000333333
332200001111111111110000002233
332200001111111111110000002233
000000555555555555555555000000
000000555555555555555555000000
111100552200000000225500111111
111100552200000000225500111111
000000550044444444005500000000
000000550044444444005500000000
000022550044000044005522000000
000022550044000044005522000000
000000550000111100005500000000
000000550000166100005500000000
000000550000166100005500000000
000000550000111100005500000000
000022550044000044005522000000
000022550044000044005522000000
000000550044444444005500000000
000000550044444444005500000000
111100552200000000225500111111
111100552200000000225500111111
000000555555555555555555000000
000000555555555555555555000000
332200001111111111110000002233
332200001111111111110000002233
333333000011111111000000333333
333333220000000000000022333333
333333220011112211110022333333
000000000011112211110000000000
221100112200000000000022110011
221100112200000000000022110011
221100112200000000000022110011
221100112200000000000022110011