000000000000110000440011110000
000000000000110000440011110000
000000000000220000003344110000
000000000000220000003344110000
000000330011002244001100000000
000000330011002244001100000000
003300114411003300112233000000
003300114411003300112233000000
004400000000110000442200441100
004400000000110000442200441100
000011000022000000111111001111
000011000022000000111111001111
000000334400000033442233330000
000000334400000033442233330000
000011110011220000003300004400
000011110011220000003300004400
000000000000113311441133001111
000000000000113311441133001111
220011331111001100111100220000
220011331111001100111100220000
000000004400003300000022330000
000000004400003300000022330000
441111003300113300004400110011
441111003300113300004400110011
443344004411000011000000110044
443344004411000011000000110044
004400000000000000001100440000
004400000000000000001100440000
114400001100004400001111001100
114400001100004400001111001100
000011000000004400001100004400
000011000000004400001100004400
000022110000001111000000111111
000022110000001111000000111111
000000110000000000001100000000
000000110000011110001100000000
000044000000016610110000000000
000044000000016610110000000000