000000220044440000111133330000
000000220044440000111133330000
000000110011000000110033110000
000000110011000000110033110000
111100441100113300001100111122
111100441100113300001100111122
111155440000000000220022551100
111155440000000000220022551100
110011442200002200000011333322
110011442200002200000011333322
111133550000445500001111001133
111133550000445500001111001133
000011110000111133110011001100
000011110000111133110011001100
110000000011115533442200112200
110000000011115533442200112200
113333003333331122001100442211
113333003333331122001100442211
004400111133551111110055111111
004400111133551111110055111111
001133332211113344220000444400
001133332211113344220000444400
111144110011110011000000111111
111144110011110011000000111111
111100441111111111440011114433
111100441111111111440011114433
000011443300000000110000004411
000011443300000000110000004411
110011001100335511441100111133
110011001100335511441100111133
111111114400551100001100111100
111111114400551100001100111100
111111111144005544111133110011
111111111144005544111133110011
000011115500000011001111000055
000011115500011111001111000055
111100004400016610331122001133
111100004400016610331122001133