000000000000000000000000000000
000000000000000000000000000000
000000000000000000000000000000
222002222200111111002222200222
222002222200111111002222200222
000000000000000000000000000000
444444005555555555555500444444
444444005555555555555500444444
000000002222000022220000000000
555555552222000022225555555555
555555550000000000005555555555
000000000044444444000000000000
111100220044444444002200111111
111100220000000000002200111111
000000225555555555552200000000
444444445555555555554444444444
444444445555555555554444444444
000000000000222200000000000000
555555110000222200001155555555
555555115555555555551155555555
000000005555555555550000000000
440044440000000000004444004444
440044440022222222004444004444
000000000022222222000000000000
555555555555555555555555555555
555555555555555555555555555555
000000000000000000000000000000
444444444400555500444444444444
444444444400555500444444444444
000000000000555500000000000000
111100110022222222001100111111
111100110022222222001100111111
000000000000000000000000000000
555555555555555555555555555555
555555555555555555555555555555
000000000001111110000000000000
000000000001666610000000000000
000000000001666610000000000000