000011000011000000004400330000
000011000011000000004400330000
000044440000110000001100000000
000044440000110000001100000000
113333111100004400110000001144
113333111100004400110000001144
110011000000110000441111001133
110011000000110000441111001133
440000110011441111112200110044
440000110011441111112200110044
000011000033001100440000444411
000011000033001100440000444411
111111113300111100000000000000
111111113300111100000000000000
111111331100110011224400000011
111111331100110011224400000011
002211110000111144001111004411
002211110000111144001111004411
334400001133330000001100111100
334400001133330000001100111100
001100000011000011441100110000
001100000011000011441100110000
110011001111001133440011000000
110011001111001133440011000000
440011113311001111333344330044
440011113311001111333344330044
113300001111110000000011440000
113300001111110000000011440000
111100111111221100000033001100
111100111111221100000033001100
004411331100000011000000001144
004411331100000011000000001144
113300001144111133330011113333
113300001144111133330011113333
112200111100000000220044221100
112200111100011110220044221100
001100000000016610111111331111
001100000000016610111111331111