000000000000000000000000000000
000000000000000000000000000000
000000000000000000000000000000
111111110011111111001111111111
111111110011111111001111111111
110000000000000000000000000011
110022221111002222111100222211
110022221111002222111100222211
000011000000001100000000110000
110011001111111100111100110011
110011001111111100111100110011
110000001144441100114444110011
221122001144441100114444110011
000000000000000000000000000000
111111002222222200222222220011
333311002222222200222222220033
333311000000000000000000000033
000000001111115555551111110000
111111001111115555551111110011
110000000000000000000000000011
110022111100222222001111220011
110022111100222222001111220011
000011000000113311000000110000
110011001100113311001100110011
110000001100000000001100000011
111122001111112211111100221111
111122001111112211111100221111
000000000000000000000000000000
111111001111000000111100111111
111111001111000000111100111111
000000000000000000000000000000
002222000022222222000022220000
002222000022222222000022220000
000000000000000000000000000000
000000000001111110000000000000
000000000001666610000000000000
000000000001666610000000000000
000000000001111110000000000000