000000000000000000000000000000
000000000000000000000000000000
000000000000000000000000000000
555555555500000000005555555555
555555555500000000005555555555
555555555500000000005555555555
555555555500222200005555555555
555555555500222200005555555555
555555555500000000005555555555
555555555555555555555555555555
555555555555555555555555555555
555555555555555555555555555555
555555555555555555555555555555
550000005500000000005500000055
550022005500222200005500220055
550022005500222200005500220055
550000005500000000005500000055
555555555555555555555555555555
555555555555555555555555555555
555555555555555555555555555555
555555555555555555555555555555
550000005500000000005500000055
550022005500222200005500220055
550022005500222200005500220055
550000005500000000005500000055
555555555555555555555555555555
555555555555555555555555555555
555555555555555555555555555555
555555555555555555555555555555
555555555500000000005555555555
555555555500000000005555555555
555555555500222222005555555555
000000000000000000000000000000
000000000000000000000000000000
111111000000011110000000111111
111111000000016610000000111111
000000000000016610000000000000
000000000000011110000000000000