000000000000000000000000000000
000000000000000000000000000000
000000000000000000000000000000
333330000011111111110000033333
333330000011111111110000033333
000000222000000000000222000000
111100222003333333300222001111
111100000003333333300000011111
000000444444442244444444000000
111100444444442244444444001111
555555555555000000555555555555
555555555555000000555555555555
555522555522222222225555225555
555522555522222222225555225555
555555555555555555555555555555
000000000000111100000000000000
333333311100111100111333333333
333333311100000000111333333333
000000000022222222000000000000
444400444444444444444400444400
444400444444444444444400444400
000000000011000011000000000000
333003330011000011003330033300
333003330011111111003330033300
000000000000000000000000000000
555555555522222222555555555555
555555555522222222555555555555
000000000000000000000000000000
111111110000111100001111111111
111111110000111100001111111111
000000000000000000000000000000
555500555555555555555555005555
555500555555555555555555005555
111100000000000000000000001111
111100000000111111000000001111
000000000000166661000000000000
000000000000166661000000000000
001111000000111111000000000000