000033111133440000111111000000
000033111133440000111111000000
000011001100440000000011440000
000011001100440000000011440000
110000004400000011220011110011
110000004400000011220011110011
112211443311110011111111002211
112211443311110011111111002211
113300115511331100224400440011
113300115511331100224400440011
114433002200112222003311110022
114433002200112222003311110022
000000005500330011440011005522
000000005500330011440011005522
000000111100440000000033003311
000000111100440000000033003311
001155000011110044111100111100
001155000011110044111100111100
112200443355111122111100000011
112200443355111122111100000011
000011001100441133001100221111
000011001100441133001100221111
002211000000110033331100001111
002211000000110033331100001111
113311000011330000005511001111
113311000011330000005511001111
000055111155001100331100111133
000055111155001100331100111133
220000330000000033220011110055
220000330000000033220011110055
110044110044115533110000001111
110044110044115533110000001111
112233110022111100001144110011
112233110022111100001144110011
330011331100000033110022114433
330011331100011133110022114433
002211003300016610002211225555
002211003300016610002211225555