000000000000000000000000000000
000000000000000000000000000000
000000000000000000000000000000
333333333333333333333333333333
333333333333333333333333333333
333333333333333333333333333333
332222223322222222332222223333
332222223322222222332222223333
330000223300000000332200003333
330000223300000000332200003333
333333223333333333332233333333
333333223333333333332233333333
332222222222220022222222223333
332222222222220022222222223333
333333000000000000000033333333
333333000000000000000033333333
332222332222222222332222333333
332222332222222222332222333333
332200002200000022000022333333
332200002200000022000022333333
332233332233333322333322333333
332233332233333322333322333333
330000000000220000000000333333
330000000000220000000000333333
332222222233223322222222333333
332222222233223322222222333333
333333333333333333333333333333
333333333333333333333333333333
333333333333333333333333333333
330000000000000000000000333333
330000000000000000000000333333
330000000000000000000000333333
000000000000000000000000000000
000000000000000000000000000000
000000000001111110000000000000
000000000001666610000000000000
000000000001666610000000000000
000000000001111110000000000000