000000111100000000330011110000
000000111100000000330011110000
000000330000000000110022000000
000000330000000000110022000000
001100000011000000114411000000
001100000011000000114411000000
331111000011441111110000220011
331111000011441111110000220011
000000001100334411111111111100
000000001100334411111111111100
000011441122001100110033000011
000011441122001100110033000011
000033111111001100330011001100
000033111111001100330011001100
110000114400000011440000110044
110000114400000011440000110044
333300110011331100000011110000
333300110011331100000011110000
111111000000220000002211114444
111111000000220000002211114444
111144003300220000000011000000
111144003300220000000011000000
004400000000440000330000000000
004400000000440000330000000000
000022000011000000000000000022
000022000011000000000000000022
004400000000000044000000110011
004400000000000044000000110011
000000110000220000000000000044
000000110000220000000000000044
000011221100000000000011441100
000011221100000000000011441100
001100110000001100003300441100
001100110000001100003300441100
003322110000000000114400110033
003322110000011110114400110033
004411334400016610004444001100
004411334400016610004444001100