000000000033000000110044220000
000000000033000000110044220000
000000005500000000110022000000
000000005500000000110022000000
110000111100000011220000110011
110000111100000011220000110011
550044001133335511001100000011
550044001133335511001100000011
110044001100111111220000112200
110044001100111111220000112200
003300330011000011110000111111
003300330011000011110000111111
110000002255110000000000115500
110000002255110000000000115500
332222110044001111114422001155
332222110044001111114422001155
000000111144221100000011110000
000000111144221100000011110000
440000005511002200550011114411
440000005511002200550011114411
000000111111000000003300110000
000000111111000000003300110000
001100110000111111110000000022
001100110000111111110000000022
111144110011003311441122222233
111144110011003311441122222233
002200550000001100112244005544
002200550000001100112244005544
221100110022001100000000000000
221100110022001100000000000000
001111440000002200112211001111
001111440000002200112211001111
001100000000112200005522110000
001100000000112200005522110000
220000111100000000000000000033
220000111100011110000000000033
001111110000016610001122111111
001111110000016610001122111111