000044110011110000111100000000
000044110011110000111100000000
000022220022110000110000000000
000022220022110000110000000000
000000330000004411220022000000
000000330000004411220022000000
441133110000334444440011441111
441133110000334444440011441111
114444551155114411001144000044
114444551155114411001144000044
331100330000440011111100001100
331100330000440011111100001100
113311001111004433331144111111
113311001111004433331144111111
444444111111221111114400002211
444444111111221111114400002211
000011111111110000114400001144
000011111111110000114400001144
110022000011000000221133111111
110022000011000000221133111111
000000221100440011550000111111
000000221100440011550000111111
223355554411331111113311441111
223355554411331111113311441111
221111110000111111114411221111
221111110000111111114411221111
000000000011441100003300110000
000000000011441100003300110000
000011114400444411111100001111
000011114400444411111100001111
114422335511001111110000551144
114422335511001111110000551144
001111001155331100111111440011
001111001155331100111111440011
000011113300000011001100111111
000011113300022211001100111111
110044001100026620000044112200
110044001100026620000044112200