000000110011000000001111110000
000000110011000000001111110000
000044110000000000111100110000
000044110000000000111100110000
000000001144000000001100000011
000000001144000000001100000011
000011110044110000111100440011
000011110044110000111100440011
000011111111001100110000111133
000011111111001100110000111133
110033110022004400001133111100
110033110022004400001133111100
110011331144111100000011000033
110011331144111100000011000033
114411001111111100000011000011
114411001111111100000011000011
440000110022440000441100001111
440000110022440000441100001111
111111000011001100110011004400
111111000011001100110011004400
220022000000002211111111110000
220022000000002211111111110000
111111441111440011111111441100
111111441111440011111111441100
113300001111000022111111442200
113300001111000022111111442200
110011004400110000001100223300
110011004400110000001100223300
001100001144111133000000110011
001100001144111133000000110011
330000000011112211110011110000
330000000011112211110011110000
111100000000114444111111111133
111100000000114444111111111133
001133004400000000000011111100
001133004400011110000011111100
110000110000016610001100001100
110000110000016610001100001100