000011002211110000110000330000
000011002211110000110000330000
000011110000110000001133000000
000011110000110000001133000000
001111004400330011333300000033
001111004400330011333300000033
001100001100001111111100331100
001100001100001111111100331100
113300440000001111331111441100
113300440000001111331111441100
000000111100110000001100000000
000000111100110000001100000000
000011114400111100000000003300
000011114400111100000000003300
113300002211111111110011330011
113300002211111111110011330011
004400110011111111330011000000
004400110011111111330011000000
000033114422110000001122110000
000033114422110000001122110000
110011003311000000000011221100
110011003311000000000011221100
331111114422001100001100110000
331111114422001100001100110000
000011111100001122111144114400
000011111100001122111144114400
001100000011112200001111110000
001100000011112200001111110000
001133000033114411111100330000
001133000033114411111100330000
003300001111000011111111330011
003300001111000011111111330011
330011111111110011443311330000
330011111111110011443311330000
001144000000000000221100111133
001144000000011110221100111133
001111000000016610441144110011
001111000000016610441144110011